1111111111111111111111111111111111111111111111111111111111111111111111111111111
1000000000000000000000000000000000000000000000000000000000000000000000000000001
1000000000000000000000000000000000000000000000000000000000000000000000000000001
1000000000000000000000000000000000000000001111111000000000000000000000000000001
100000000000000000000000000000000000000001      1000000000000000000000000000001
10000000000000000000000000000000000000001       1000000000000000000000000000001
1000000000000000000000000000000000000001        1000000000000000000000000000001
100000000000000000000000000000000000001         1000000000000000000000000000001
10000000000000000000000000000000000001          1111111111111111111111111111111
1000000010000000000000000000000000001
100N0001 100000000000000000000000001
1000001   1000000000000000000000001
1000001   100000000000000000000001
1000001   10000000000000000000001
10000001110000000000000000000001
1000000000000000000000000000001
1111111111111111111111111111111
