 11111                  11111
100000111111111111111111000001
1000N0000000000000000000000001
100000111111111011111111000001
 11011       10001      11011
  101        10001      10001
  101        10001      10001
  100111111110000011111110001
  100000000000000000000000001
  101111111110000011111111111
  101        11111
   1