1111111111111111111111111111111111111111111111111
1000000000000000000001000000000000000000000000001
1000000000000000000001000000000000000000000000001
1000000000000000000001000000000000000000000000001
1000000000000000000001000000000000000000000000001
1000000000000000000001000000000000000000000000001
1000000000000000000001000000000000000000000000001
1000000000000000000001000000000000000000000000001
1000000000000000000001000000000000000000000000001
1000000010011111111001000000000000000000000000001
100N0001 1000000001001000000000000000001111111111
1000001   100000001001000000000000000001
1000001   100000001001000000000111100001
1000001   100000001111000000001   100001111111111
1000000111000000001111000000001   100000000000001
1000000000000000000000000000001   100000000000001
1111111111111111111111111111111   111111111111111
